111111111111111
1C20020000000C1
1000001C1000201
1P00001110000C1
1020001E1000001
100C0000002C001
111111111111111