1111111111111111111111111111111111111111
1CCCCCCC000000000CCC000000000000CCCCCCC1
1111111111111101111111011111111111111111
100000001CCCCCCCCCCCCCCCCCCC100000000001
1CCCCC0000000011111111100000000000CCCCC1
111111111011111CCC1CCC111110111111111111
1C10000000100C0211E1100C001000C0000001C1
100C00C10010010010001001001000100C00C001
100C00C10010010000100001001000100C00C001
100C00C100C001C010P010C100C000100C00C001
111100111111111111C111111111111111001111
1CC1000000000000010100000000000000001CC1
10010000CCCC000010C010000CCCC00000001001
10000000000000010C0C01000000000000000001
10000C000C000010C0C0C010000C000C00000001
1CC00010100000010C0C01000000101000000CC1
1CC0000C0000000010C0100000000C0000000CC1
1000001010001111100011111000101000000001
10000C000C0010C0101010C0100C000C00000001
1000000000001C100C1C001C1000000000000001
1111111111111111111111111111111111111111